X X X 0 0 0 0 X X X
X 0 0 0 0 0 0 0 0 X
X 0 0 0 0 0 0 0 0 X
0 0 0 0 X X 0 0 A 0
0 0 0 X X X X S 0 0
0 0 0 X X X X 0 0 0
0 0 0 0 X X 0 0 0 0
X 0 0 0 0 0 0 0 0 X
X 0 0 0 0 0 0 0 0 X
X X X 0 0 0 0 X X X