0 0 0 0 0 0 0 0 0 L
0 X X X 0 P X X X A
0 X X X 0 0 X X X 0
0 X X X 0 0 X X X 0
0 0 0 0 0 S 0 0 0 0
0 0 R 0 0 0 0 0 0 0
0 X X X 0 0 X X X 0
0 X X X 0 0 X X X 0
0 X X X H 0 X X X 0
0 0 0 0 0 0 0 0 0 0